{
    "name": "Home",
    "raw" : "                                                                  
 ┌────────────┤  ├─────────────┐  ┌────────────┤  ├─────────────┐ 
 │~~~~~~~~~~~~│  │~~~~~~~~~~~~~│  │~~~~~~~~~~~~│  │~~~~~~~~~~~~~│ 
 │~~~~~~~~~~~~│  │~~~~~~~~~~~~~│  │~~~~~~~~~~~~│  │~~~~~~~~~~~~~│ 
 │~~~~~~~~~~~~│  │~~~~~~~~~~~~~│  │~~~~~~~~~~~~│  │~~~~~~~~~~~~~│ 
 ┴────────────┘  └─────────────│  ┴────────────┘  └─────────────│ 
                                                                  
 ┬────────────┐                │  ┬────────────┐                │ 
 │╒╒╒╒╒╒╒╒╒╒╒╒┆                │  │╒╒╒╒╒╒╒╒╒╒╒╒┆                │ 
 │╒╒╒╒╒╒╒╒╒╒╒╒┆                │  │╒╒╒╒╒╒╒╒╒╒╒╒┆                │ 
 │╒╒╒╒╒╒╒╒╒╒╒╒┆                │  │╒╒╒╒╒╒╒╒╒╒╒╒┆                │ 
 │╒╒╒╒╒╒╒╒╒╒╒╒┆                │  │╒╒╒╒╒╒╒╒╒╒╒╒┆                │ 
 │╒╒╒╒╒╒╒╒╒╒╒╒┆                │  │╒╒╒╒╒╒╒╒╒╒╒╒┆                │ 
 │╒╒╒╒╒╒╒╒╒╒╒╒┆                │  │╒╒╒╒╒╒╒╒╒╒╒╒┆                │ 
 └────────────┤  ├─────────────┘  └────────────┤  ├─────────────┘ 
                                                                  ",
    "init_pos": [6, 1],
    "exits":{
                "6,0" : ["Large Home", [5, 95]],
                "6,64" : ["Large Home", [5, 1]]
                },
    "items": {
        "Test": [0, 0]
    }
}
