{
    "name": "Home",
    "raw" : "┌────────────┤  ├─────────────┐  ┌────────────┤  ├─────────────┐ 
│~~~~~~~~~~~~│  │~~~~~~~~~~~~~│  │~~~~~~~~~~~~│  │~~~~~~~~~~~~~│ 
│~~~~~~~~~~~~│  │~~~~~~~~~~~~~│  │~~~~~~~~~~~~│  │~~~~~~~~~~~~~│ 
│~~~~~~~~~~~~│  │~~~~~~~~~~~~~│  │~~~~~~~~~~~~│  │~~~~~~~~~~~~~│ 
┴────────────┘  └─────────────│  ┴────────────┘  └─────────────│ 
                                                                 
┬────────────┐                │  ┬────────────┐                │ 
│╒╒╒╒╒╒╒╒╒╒╒╒┆                │  │╒╒╒╒╒╒╒╒╒╒╒╒┆                │ 
│╒╒╒╒╒╒╒╒╒╒╒╒┆                │  │╒╒╒╒╒╒╒╒╒╒╒╒┆                │ 
│╒╒╒╒╒╒╒╒╒╒╒╒┆                │  │╒╒╒╒╒╒╒╒╒╒╒╒┆                │ 
│╒╒╒╒╒╒╒╒╒╒╒╒┆                │  │╒╒╒╒╒╒╒╒╒╒╒╒┆                │ 
│╒╒╒╒╒╒╒╒╒╒╒╒┆                │  │╒╒╒╒╒╒╒╒╒╒╒╒┆                │ 
│╒╒╒╒╒╒╒╒╒╒╒╒┆                │  │╒╒╒╒╒╒╒╒╒╒╒╒┆                │ 
└────────────┤  ├─────────────┘  └────────────┤  ├─────────────┘ 
┌────────────┤  ├─────────────┐  ┌────────────┤                  ",
    "init_pos": [5, 0],
    "exits": {},
    "items": {
        "Test": [5, 2]
    }
}
