{
    "raw" : "┌────────────┤  ├─────────────┐  ┌────────────┤  ├─────────────┐  ┌────────────┤  ├─────────────┐
│~~~~~~~~~~~~│  │~~~~~~~~~~~~~│  │~~~~~~~~~~~~│  │~~~~~~~~~~~~~│  │~~~~~~~~~~~~│  │~~~~~~~~~~~~~│
│~~~~~~~~~~~~│  │~~~~~~~~~~~~~│  │~~~~~~~~~~~~│  │~~~~~~~~~~~~~│  │~~~~~~~~~~~~│  │~~~~~~~~~~~~~│
│~~~~~~~~~~~~│  │~~~~~~~~~~~~~│  │~~~~~~~~~~~~    ~~~~~~~~~~~~~│  │~~~~~~~~~~~~│  │~~~~~~~~~~~~~│
┴────────────┘  └─────   ─────│  ┴─────  ─────┘  └─────────────│  ┴────────────┘  └─────────────│
                                                                                                 
┬────────────┐                │  ┬────────────┐                │  ┬────────────┐                │
│╒╒╒╒╒╒╒╒╒╒╒╒┆                │  │╒╒╒╒╒╒╒╒╒╒╒╒┆                │  │╒╒╒╒╒╒╒╒╒╒╒╒┆                │
│╒╒╒╒╒╒╒╒╒╒╒╒┆                │  │╒╒╒╒╒╒╒╒╒╒╒╒┆                │  │╒╒╒╒╒╒╒╒╒╒╒╒┆                │
│╒╒╒╒╒╒╒╒╒╒╒╒┆                │  │╒╒╒╒╒╒╒╒╒╒╒╒                 │  │╒╒╒╒╒╒╒╒╒╒╒╒┆                │
│╒╒╒╒╒╒╒╒╒╒╒╒┆                │  │╒╒╒╒╒╒╒╒╒╒╒╒                 │  │╒╒╒╒╒╒╒╒╒╒╒╒┆                │
│╒╒╒╒╒╒╒╒╒╒╒╒┆                │  │╒╒╒╒╒╒╒╒╒╒╒╒┆                │  │╒╒╒╒╒╒╒╒╒╒╒╒┆                │
│╒╒╒╒╒╒╒╒╒╒╒╒┆                │  │╒╒╒╒╒╒╒╒╒╒╒╒┆                │  │╒╒╒╒╒╒╒╒╒╒╒╒┆                │
└────────────┤  ├─────────────┘  └────────────┤  ├─────────────┘  └────────────┤  ├─────────────┘
┌────────────┤  ├─────────────┐  ┌────────────┤  ├─────────────┐  ┌────────────┤  ├─────────────┐
│~~~~~~~~~~~~│   ~~~~~~~~~~~~~│  │~~~~~~~~~~~~│  │~~~~~~~~~~~~~│  │~~~~~~~~~~~~│  │~~~~~~~~~~~~~│
│~~~~~~~~~~~~   │~~~~~~~~~~~~~│  │~~~~~~~~~~~~    ~~~~~~~~~~~~~│  │~~~~~~~~~~~~│  │~~~~~~~~~~~~~│
│~~~~~~~~~~~~│  │~~~~~~~~~~~~~│  │~~~~~~~~~~~~│  │~~~~~~~~~~~~~│  │~~~~~~~~~~~~│  │~~~~~~~~~~~~~│
┴────────────┘  └─────────────│  ┴────────────┘  └─────────────│  ┴────────────┘  └─────────────│
┬────────────┐                │  ┬────────────┐                │  ┬────────────┐                │
│╒╒╒╒╒╒╒╒╒╒╒╒┆                │  │╒╒╒╒╒╒╒╒╒╒╒╒┆                │  │╒╒╒╒╒╒╒╒╒╒╒╒┆                │
│╒╒╒╒╒╒╒╒╒╒╒╒┆                │  │╒╒╒╒╒╒╒╒╒╒╒╒┆                │  │╒╒╒╒╒╒╒╒╒╒╒╒┆                │
│╒╒╒╒╒╒╒╒╒╒╒╒┆                │  │╒╒╒╒╒╒╒╒╒╒╒╒┆                │  │╒╒╒╒╒╒╒╒╒╒╒╒┆                │
│╒╒╒╒╒╒╒╒╒╒╒╒┆                │  │╒╒╒╒╒╒╒╒╒╒╒╒┆                │  │╒╒╒╒╒╒╒╒╒╒╒╒┆                │
│╒╒╒╒╒╒╒╒╒╒╒╒┆                │  │╒╒╒╒╒╒╒╒╒╒╒╒┆                │  │╒╒╒╒╒╒╒╒╒╒╒╒┆                │
│╒╒╒╒╒╒╒╒╒╒╒╒┆                │  │╒╒╒╒╒╒╒╒╒╒╒╒┆                │  │╒╒╒╒╒╒╒╒╒╒╒╒┆                │
└────────────┤  ├─────────────┘  └────────────┤  ├─────────────┘  └────────────┤  ├─────────────┘
┌────────────┤  ├─────────────┐  ┌────────────┤  ├─────────────┐  ┌────────────┤  ├─────────────┐
│~~~~~~~~~~~~│  │~~~~~~~~~~~~~│  │~~~~~~~~~~~~│  │~~~~~~~~~~~~~│  │~~~~~~~~~~~~│  │~~~~~~~~~~~~~│
│~~~~~~~~~~~~│  │~~~~~~~~~~~~~│  │~~~~~~~~~~~~│  │~~~~~~~~~~~~~│  │~~~~~~~~~~~~│  │~~~~~~~~~~~~~│
│~~~~~~~~~~~~│  │~~~~~~~~~~~~~│  │~~~~~~~~~~~~│  │~~~~~~~~~~~~~│  │~~~~~~~~~~~~│  │~~~~~~~~~~~~~│
┴────────────┘  └─────────────│  ┴────────────┘  └─────────────│  ┴────────────┘  └─────────────│
┬────────────┐                │  ┬────────────┐                │  ┬────────────┐                │
│╒╒╒╒╒╒╒╒╒╒╒╒┆                │  │╒╒╒╒╒╒╒╒╒╒╒╒┆                │  │╒╒╒╒╒╒╒╒╒╒╒╒┆                │
│╒╒╒╒╒╒╒╒╒╒╒╒┆                │  │╒╒╒╒╒╒╒╒╒╒╒╒┆                │  │╒╒╒╒╒╒╒╒╒╒╒╒┆                │
│╒╒╒╒╒╒╒╒╒╒╒╒┆                │  │╒╒╒╒╒╒╒╒╒╒╒╒┆                │  │╒╒╒╒╒╒╒╒╒╒╒╒┆                │
│╒╒╒╒╒╒╒╒╒╒╒╒┆                │  │╒╒╒╒╒╒╒╒╒╒╒╒┆                │  │╒╒╒╒╒╒╒╒╒╒╒╒┆                │
│╒╒╒╒╒╒╒╒╒╒╒╒┆                │  │╒╒╒╒╒╒╒╒╒╒╒╒┆                │  │╒╒╒╒╒╒╒╒╒╒╒╒┆                │
│╒╒╒╒╒╒╒╒╒╒╒╒┆                │  │╒╒╒╒╒╒╒╒╒╒╒╒┆                │  │╒╒╒╒╒╒╒╒╒╒╒╒┆                │
└────────────┤  ├─────────────┘  └────────────┤  ├─────────────┘  └────────────┤  ├─────────────┘
┌────────────┤  ├─────────────┐  ┌────────────┤  ├─────────────┐  ┌────────────┤  ├─────────────┐
│~~~~~~~~~~~~│  │~~~~~~~~~~~~~│  │~~~~~~~~~~~~│  │~~~~~~~~~~~~~│  │~~~~~~~~~~~~│  │~~~~~~~~~~~~~│
│~~~~~~~~~~~~│  │~~~~~~~~~~~~~│  │~~~~~~~~~~~~│  │~~~~~~~~~~~~~│  │~~~~~~~~~~~~│  │~~~~~~~~~~~~~│
│~~~~~~~~~~~~│  │~~~~~~~~~~~~~│  │~~~~~~~~~~~~│  │~~~~~~~~~~~~~│  │~~~~~~~~~~~~│  │~~~~~~~~~~~~~│
┴────────────┘  └─────────────│  ┴────────────┘  └─────────────│  ┴────────────┘  └─────────────│
┬────────────┐                │  ┬────────────┐                │  ┬────────────┐                │
│╒╒╒╒╒╒╒╒╒╒╒╒┆                │  │╒╒╒╒╒╒╒╒╒╒╒╒┆                │  │╒╒╒╒╒╒╒╒╒╒╒╒┆                │
│╒╒╒╒╒╒╒╒╒╒╒╒┆                │  │╒╒╒╒╒╒╒╒╒╒╒╒┆                │  │╒╒╒╒╒╒╒╒╒╒╒╒┆                │
│╒╒╒╒╒╒╒╒╒╒╒╒┆                │  │╒╒╒╒╒╒╒╒╒╒╒╒┆                │  │╒╒╒╒╒╒╒╒╒╒╒╒┆                │
│╒╒╒╒╒╒╒╒╒╒╒╒┆                │  │╒╒╒╒╒╒╒╒╒╒╒╒┆                │  │╒╒╒╒╒╒╒╒╒╒╒╒┆                │
│╒╒╒╒╒╒╒╒╒╒╒╒┆                │  │╒╒╒╒╒╒╒╒╒╒╒╒┆                │  │╒╒╒╒╒╒╒╒╒╒╒╒┆                │
│╒╒╒╒╒╒╒╒╒╒╒╒┆                │  │╒╒╒╒╒╒╒╒╒╒╒╒┆                │  │╒╒╒╒╒╒╒╒╒╒╒╒┆                │
└────────────┤  ├─────────────┘  └────────────┤  ├─────────────┘  └────────────┤  ├─────────────┘",
    "init_pos" : [5, 0]
}